%%%%%%%%%%%%%%%%%%%%%%%%%%%%%%%%%%%%%%%%%
%      ................................P%
%.%%%% ...%%%%%%  %% %    %%%% %%%%%%%% %
% %%..... ..... %%%  ... ....... %%.... %
%.%......% . .. %  %  . %%%%%%%% %% %%%%%
% %......% %    o %% ........ %% %%.... %
%.%% % % % % % .... %%%%  %%%    %%%%%% %
% %  % ........   %    %% %%%%  ....    % 
% %% % % %%%% ....%%%% .. ...    %% %%%%%
%.%% % ......   ...... %%  ........%%   %
%    %%%%%%%%%%% %%%%%%%         %%%%%% %
%%%%%% ..............    %%%% .... ...  %
% ..  %%%%  %%%%%%   %%%  ..  .......%%%%
% %%%%%%   ..... ...  .... %%%%% %%% .  %
% o   .....   %%%%%% %%%%%%%%%%% %%  %% %
%%%%%% ...   ................    %%%%%% %
%..........%%%%%%%%%%%%%%%%%%%%%   .... %
%%%%%%%%%%%%%%%%%%%%%%%%%%%%%%%%%%%%%%%%%